SO blabla.xpm
EA blabla.xpm
WE blabla.xpm
NO blabla.xpm

C 51,198,122
F 184,113,11

111111111111111
1S0000000000001
100000000000001
100000000000001
100000000000001
100000000000001
100000000000001
100000000001111
100000000000001
100000000000001
100000000000001
100000000000001
111111111111111