NO ./texture/wall_1.xpm
SO ./texture/wall_2.xpm
EA ./texture/wall_3.xpm
WE ./texture/wall_4.xpm

C 128,70,45
F 5,70,255

11111111111111111111111111
10000000001110000110000001
10110000011100000111100011
10110000001000W000000011111111111
11111111101100000111000000000000111
100000000011000101110111111111111
11110111111111000111011111111
1111011111111101110101001000111111111111    111111
11000000110101011100000011000000000000111111000011
1000000000000000011000000100011111111000000000111
10000000000000011110100100011       11111111111
11000001110101011111111 10001
11110111 1110101 111111 10011
11111111 1111111 111111 11111