SO blabla.xpm
EA blabla.xpm
WE blabla.xpm
NO blabla.xpm

C 51,198,122
F 184,113,111

            1111111
         111110001111
         1100000000111
        111000011111111111
       11100111        111
 111111100011           111
 1100001100011          111   
 1100001110000111       1111
 110000110000011111111111111
 1100001100000000010000000011
 1100000111D11111110000000011
 11000000000000E00D0000000011
 110000110000000001000000001
 110001110000000001000000001
  11111111000011111111101111
        1100000111 111100111
        1100000011  11000111
        1100000001   1000001
        1111111111   1111111