SO blabla.xpm
EA blabla.xpm
WE blabla.xpm
NO blabla.xpm

C 51,198,122
F 184,113,111

111111111111111
111111111111111
111111111111N01
111111111111111