SO blabla.xpm
EA blabla.xpm
WE blabla.xpm
NO blabla.xpm

C 51,198,122
F 184,113,111

111111111111111
100000000000001
100000000000001
100000000000001
100000000000001
100000000000001
100000000000001111111111111111111111111111111111111111111111111111111111111111111111111111
100000000000000000000000000000000000000000000000000000000000000000000000000000000001000001
100000000000000000000000000000000000000000000000000000000000000000000000000000000001000111
111111111N00000000000000000000000000000000000000000000000000000000000000000000000001000001
100000000000000000000000000000000000000000000000000000000000000000000000000000000001000001
101111111111111111111111111111111111111111111111111111111111111111111111111111111111111111
