NO                              
WE ./path_to_the_west_texture
SO ./path_to_the_south_texture
EA ./path_to_the_east_texture

F 184,113,255
C 51,198,255

1111111111111111111111111
1000000000110000000000001
1011000001110000000000001
100100000000000000000000111111111
111111111011000001110000000000001
100000000011000001110111111111111
11110111111111000010001
11110111111111011101010010001111111111      11111
1100000011010101110000001000000000000011111100001
100000000000000011000000100011111111100000000111
10000000000000001101010010001       1111111111
11000001110101011111011110N0111
11110111 1110101 101111010001
11111111 1111111 111111111111