NO blabla.xpm
SO blabla.xpm
EA blabla.xpm
WE blabla.xpm

C 51,198,122
F 184,113,111

1111111111111111111111111
10000000000110000110000001
1001000001110000011110001
10010000000000000000001111111111
11111111101100000111000000000001111
100000000011000001110111111111111
11110111111111000010001111111
111101111111110111010100100011111111111    111111
11000000110101011100000010000000000000111111000011
10000000N0000000011000000100011111111100000000111
10000000000000011010100100011       11111111111
11000001110101011111011 10001
11110111 1110101 101111 10011
11111111 1111111 111111 11111