SO blabla.xpm
EA blabla.xpm
WE blabla.xpm
NO blabla.xpm

C 51,198,122
F 184,113,111

111111111111111
100000010000001
100000010000001
100000010000001
100000000000001
100000000010001
100000000010001
1000000N0000001
111100000000001
100000000011111
100000011110001
100000000000001
111111111111111